1111111111111111111111111111111
1P0111000C011111110001000100011
1100110111001111110101010101011
10011C01111011111101C1010101C11
1100110011100111110101010101011
11C0110011110011110101010101011
1001110011111001110101010101011
1001110111111101110101010101011
110000C111111100000100010001E11
1111111111111111111111111111111
