11111
01001
0P001
0C001
0E001
11111